111111111111111111111111
1P000000000000000C0000X1
111111111111000X00110001
100000000001000000110C01
1CX0000000010X000C00X001
100000000111001111000001
1E0000000000000X00001111
111111111111111111111111