1111111111111111111111111111111111
1P000000000000000000000000C0000001
1000000000000000000000000000000001
11111111111111111X1111011110000001
111111000000E000000000000110011101
1111100000000000001111000110011111
11110000C0000000001111000110000001
11100011110000000011110001100C0001
11000111111000000000000C0110000011
1000C011110000000000000000000000C1
1000000110000111100C00000000000001
1C00000000000000100000000000000001
1111111111111111111111111111111111
