111111111111111111111111
1P000000000000000C0000X1
111111111111000000110001
100000000001000000110C01
1CX00000000100000C000001
1000000001110011110000X1
1E0000000000000X00001111
111111111111111111111111