111111111111111111111111
1X00000000000000000000E1
101111111110011111111101
101C0000000000C00000C101
100011111110011111110001
100011111110011111110001
101C0000000000000000C101
101111111110011111111101
1P0000000000000000000001
111111111111111111111111